#######
#     #
#   . #
# $$# #
# $*@ #
# # $ #
# #   #
#######