##############################
#   #     #     #     #      #
#   #     #     #     #      #
# $ #  #  #  #  #  #  #  # . #
#   #  #  #  #  #  #  #  #   #
#   #  #  #  #  #  #  #  #   #
#   #  #  #  #  #  #  #  #   #
#   #  #  #  #  #  #  #  #   #
#   #  #  #  #  #  #  #  #   #
#   #  #  #  #  #  #  #  #   #
#   #  #  #  #  #  #  #  #   #
# $ #  #  #  #@ #  #  #  # . #
#   #  #  #  #  #  #  #  #   #
#   #  #  #  #  #  #  #  #   #
#   #  #  #  #  #  #  #  #   #
#   #  #  #  #  #  #  #  #   #
#   #  #  #  #  #  #  #  #   #
#      #     #     #     #   #
#      #     #     #     #   #
##############################