     #####
     #   #
     #   #
#### #   #
#  ####$#####
#           #
# .## # ##. #
#           #
#####$####  #
   #   # ####
   # @ #
   #   #
   #####