##################
#@##             ##
# #  ###########  #
# # ##         ## #
# # #  #######  # #
# # # ##     ## # #
# # # #  ###  # # #
# # # # #.$ # # # #
# # # #  #  # # # #
# # # ##   ## # # #
# # #  #####  # # #
# # ##       ## # #
# #  #########  # #
# ##           ## #
#  #############  #
##               ##
 #################